 /---|---\
 #|  |  |#
 #|  |  |#
 #| (o) |#
 #|     |#
 \-------/